cols 10
rows 18
p 0 6 2
p 1 4 7
m ..........
m ..........
m .......%..
m ..........
m ..........
m ..........
m ..........
m ..%.......
m ..........
m ..........
m ..........
m .......%..
m ..........
m ..........
m ..........
m ..........
m ..%.......
m ..........

