cols 10
rows 10
p 0 6 2
p 1 4 7
s 4 4
s 5 5
s 4 5
s 5 4
m ..........
m ..........
m .......%..
m ..........
m ..........
m ..........
m ..........
m ..%.......
m ..........
m ..........
