rows 14
cols 20
p 0 7 2
p 1 7 17
s 7 9
s 7 10
s 6 9
s 6 10
m ....................
m .%%%%%.%%%%%%.%%%%%.
m .%.....%%%%%%.....%.
m .%.%%%...%%...%%%.%.
m .....%%%.%%.%%%.....
m .%%%.%........%.%%%.
m ...%.%.%%..%%.%.%...
m %%.%...%%..%%...%.%%
m ...%%%.%%%%%%.%%%...
m .%................%.
m .%%%.%%%%%%%%%%.%%%.
m .%%%............%%%.
m .%%%.%%%.%%.%%%.%%%.
m .........%%.........

